{
	"numTilesX": 13,
	"numTilesY": 10,
	"start" : [32,32],
	"size": [64, 64],
	"tileNames": ["", "tile01", "tile02"],
	"tiles":[
			1,1,1,1,1,1,1,1,1,1,1,1,1,
			1,2,2,2,0,0,0,0,0,0,0,0,1,
			1,0,0,2,0,0,0,0,0,0,0,0,1,
			1,2,1,2,0,0,0,0,0,0,0,1,1,
			1,0,0,0,0,0,0,0,0,0,0,0,1,
			1,0,0,0,0,0,0,0,0,0,0,1,1,
			1,0,0,0,0,0,0,0,0,0,0,2,1,
			1,0,0,0,0,0,0,0,0,0,0,2,1,
			1,1,1,1,1,1,1,1,1,1,1,1,1,
			1,1,1,1,1,1,1,1,1,1,1,1,1
			]
}